..................BS
........B..B.......S
......B..B.....B...S
.......B...........S
...................S
GGG................G
XXXXXXXXXXXXXXXXXXXX
